11111111111111
10X00000C00001
1PX011E0000011
11111111111111