11111111111111
10000000C00001
1P0011E0000001
1C00000001C001
11111111111111