111111111
1000000E1
1C00000C1
1P00X0C11
111111111